NO ./sprites/biciclatore.xpm
SO ./sprites/dragon.xpm
     WE     ./sprites/leprechaun.xpm
F 0,128,128

EA ./sprites/mauna_kea.xpm
C 0, 255, 255
11111
10D01
10N01
10001
11111
