NO ./sprites/minimal/n.xpm
SO ./sprites/minimal/s.xpm
     WE     ./sprites/minimal/w.xpm
F 0,128,128

EA ./sprites/minimal/e.xpm
C 0, 255, 255
        11111111111111111111111111
        100000000011000000000000101
        10110000011100000000000011
        1001000000000000000000001
111111111011000001110000000000001
100000000011000001110111111111111
111101111111110111001000100001
11110111111111011101010010001
11000000110101011110001010001
10000000000000001100000110001
10000W00000000001100010000001
1100000111010101111101101000111
11110111 1110101 101111110001
11111111 11111111111111111111
