EA ./sprites/jellyfish.xpm
NO ./sprites/molamola.xpm
     WE     ./sprites/whale.xpm
F 50, 52, 168

SO ./sprites/turtle.xpm
C 50, 52, 168
1111111111111111111111111
10000000011000000000000101
1001000011100000000000011
100100000000000000000001
11111111011000001110000000000001
10000000011000001110111111111111
1111011111111011100100100001
1111011111111011101010010001
1100000110101011110001010001
1000000000000001100000110001
1D000W0000000001100010000001
110000111010101111101101000111
1111011 1110101 101111110001
1111111 11111111111111111111
