EA ./sprites/minimal/e.xpm
NO ./sprites/minimal/n.xpm
     WE     ./sprites/minimal/w.xpm
F 0,128,128

SO ./sprites/minimal/s.xpm
C 0, 255, 255
1111111111
1000001001
100N00D001
1000001001
1000001111
1000000001
1000000001
1000000001
1111111111
