


	SO path/to/north.xpm
     WE      path/west.xpm
NO   test.xpm

C 254, 1,  1

EA   test.xpm

11111
100N1
10001
11111
