
   SO path/to/north.xpm
     WE      path/west.xpm
NO   test.xpm

EA     eastpath.xpm

C 254, 1,  1

   F   20 ,  1  , 24

111111111
101 1001
100111111
100 00N01
111111111
111111111
