SO path/to/north.xpm
 WE   path/west.xpm
NO  path/north.xpm

EA  path/east.xpm

C 254, 1,  1

   F   20 ,  1  , 24


11 11
101 1
100S1
11111
